Solutions to A-MAZE-ING Stacks Assignment
Cason Kirschner

MAZE NUMBER 1

***********E********
*.........*.********
***.*****.*.********
*.*.**.**.*......***
*..........*****.***
*.**************.***
*.*..............***
*.**********.*******
*............*******
**.**.****.*......**
*..........*.*******
***.*****.**.....***
*.........******.***
***.**.**.*........*
*********.**********

There IS NOT a way out
