
15 20
***********E********
*000000000*0********
***0*****0*0********
*0*0**0**0*000000***
*0000000000*****0***
*0**************0***
*0*00000000000000***
*0**********0*******
*000000000000*******
**0**0****0*000000**
*0000000000*0*******
***0*****0**00000***
*000000000******0***
***0**0**0*00000000*
*********0**********
14 9
-1 -1